{
  "id": "large-battlefield",
  "name": "大型战场",
  "layout": [
    "####################",
    "#..................#",
    "#..##.###..###.##..#",
    "#..##.###..###.##..#",
    "#..................#",
    "#..C...C....C...C..#",
    "#..................#",
    "#..##.###..###.##..#",
    "#..##.###..###.##..#",
    "#..................#",
    "#..C...C....C...C..#",
    "#..................#",
    "#..##.###..###.##..#",
    "#..##.###..###.##..#",
    "#..................#",
    "####################"
  ],
  "legend": [
    {
      "char": "#",
      "type": "wall",
      "walkable": false,
      "bulletPassable": false
    },
    {
      "char": ".",
      "type": "floor",
      "walkable": true,
      "bulletPassable": true
    },
    {
      "char": "C",
      "type": "cover",
      "walkable": true,
      "bulletPassable": false
    }
  ]
}
